#############
# SCORE: A  #
# LIFE:  A  #
# WORLD: A  #  use W A S D to move
#############

##################################
#  Z   Z    Z      Z             #
#  Z Z Z           Z             #
#  Z Z Z    Z      Z             #
#    Z      Z                 Z  #
####################             #
#  X    VVV                      #
##################################