#############
# SCORE: A  #
# LIFE:  A  #
# WORLD: A  #
#############

##################################
#                                # 
#                           ZZZ Z#
#                           ZX  Z#
#                           ZZZ Z#
#   VVVVVV                       # 
#        VVVVVV                  # 
##################################